#####################################################################################################################
######-----------------------------------------------------------------------------------------------####-----------#
#########################################################################################################-----------#
############+----------------------------------------------------------------------######################-----------#
############-----------------------------------------------------------------------######################-----------#
############-----------------------------------------------------------------------######################-----------#
############-----------------------------------------------------------------------######################-----------#
#%------------------------------------------------------------------------------------------------------------------#
############------------------------------------@-----------------------------------------------&-------------&-----#
############--------------------------------------------------------------------------------------------------------#
############-----------------------------------------------------------------------######################-----------#
############-----------------------------------------------------------------------######################-----------#
############+----------------------------------------------------------------------######################-----------#
#########################################################################################################-----------#
######-----------------------------------------------------------------------------------------------####-----------#
#####################################################################################################################